# lvlwidth 21
# lvlheight 25
# bgcolor 0 0 0
# edgecolor 0 0 255
# fillcolor 0 0 0
# pelletcolor 255 255 255
# fruittype 1
# startleveldata
0 0 0 0 0 0 0 0 0 113 21 113 0 0 0 0 0 0 0 0 0
0 107 100 100 100 100 100 100 100 106 0 105 100 100 100 100 100 100 100 108 0
0 101 2 2 2 2 2 2 2 2 2 2 2 2 2 2 2 2 2 101 0
0 101 3 100 2 100 2 2 2 2 2 2 2 2 2 100 2 100 3 101 0
0 101 2 2 2 100 2 2 2 2 2 2 2 2 2 100 2 2 2 101 0
0 101 2 100 100 100 2 100 100 100 2 100 100 100 2 100 100 100 2 101 0
0 101 2 2 2 2 2 2 2 2 2 2 2 2 2 2 2 2 2 101 0
0 101 2 2 2 2 2 2 2 100 2 100 2 2 2 2 2 2 2 101 0
0 101 2 2 2 2 2 2 2 2 2 2 2 2 2 2 2 2 2 101 0
0 101 2 2 2 2 2 2 100 100 100 100 100 2 2 2 2 2 2 101 0
0 101 2 2 2 2 2 2 0 0 0 0 0 2 2 2 2 2 2 101 0
0 101 2 120 2 107 112 2 111 100 0 100 112 2 111 108 2 120 2 101 0
0 0 2 2 2 101 2 2 100 4 200 0 100 2 2 101 2 2 2 0 0
0 105 133 112 2 110 2 2 100 100 100 100 100 2 2 110 2 111 133 106 0
0 101 2 2 2 2 2 2 0 0 0 0 0 2 2 2 2 2 2 101 0
0 101 2 2 2 2 2 2 100 100 100 100 100 2 100 100 2 2 2 101 0
0 101 2 2 2 2 2 2 0 0 0 0 0 2 2 100 2 2 2 101 0
0 101 2 2 2 2 2 100 100 100 100 100 100 100 2 100 2 2 2 101 0
0 101 2 2 2 2 2 2 2 2 2 2 2 2 2 2 2 2 2 101 0
0 101 2 2 2 2 2 2 2 2 2 2 2 2 2 2 2 2 2 101 0
0 101 2 2 2 2 2 2 2 2 2 2 2 2 2 2 2 2 2 101 0
0 101 2 2 2 2 2 2 2 2 2 2 2 2 2 2 2 2 2 101 0
101 3 120 2 2 2 2 2 2 2 2 2 2 2 2 2 2 2 120 3 101
101 2 2 2 107 100 100 100 100 108 0 107 100 100 100 100 108 2 2 2 101
105 100 100 100 106 0 0 0 0 110 21 110 0 0 0 0 105 100 100 100 106
# endleveldata